=======+===+########################################
=======+===+########################################
=======+===+=+=+=+=+=+=+=+=+########################
=======+===+=+=+=+=+=+=+=+=+#####                   
=======+===+=+=+=+=+=+=+=+=+#####       ############
            =+=+=+=+=+=+=+=+#####       ############
            =+=+=+=+=+=+=+=+#####       ############
########    =+=+=+=+=+=+=+=+#####       ############
########    =+=+=+=+=+=+=+==#   #       ############
########                    #   #####  #############
########                    #   #       ############